1111111111111111
1P00000000000001
1000000001111101
10000111110C0001
10C1000000000001
1111000000011111
1E000000000CC001
1111111111111111