11111111111111111111111111111111
111111111C00000000000000000000P1
111111111111000001000000000000E1
10000000000000000100000000011111
11111111111111111111100000010001
11110000000000000011100011C11111
1C0001111111111000000000100000C1
11111111111111111111111111111111