11111111111111111111111111111111
10000000000000010000000000000001
10C000C00000000100000000C0000001
1000000000000C010C00000000000001
100P0000011111111000000000000001
1000000001C0000000000C0000000001
10000000010000000000000000000001
10011111110C0000000000000C000001
10010000000000000000000000000001
100100C0000000000000000000000001
10000000000000000001111111110111
1000000000000000000C111000000001
10011111110000000001000011111101
100000C00100000000010C0000001101
1000111111000E000001111111000001
11111111111111111111111111111111